xxxxxxxxxxxxxxxxxxxxxxxxx
xp      x        x      x
x xxxxx xxxxxxxx x xxxxxx
x x            x x x   x
x x xxxxxxxxxx x x x x x
x x x    x     x x x x x
x x x xx x xx  x x x x x
x x x x      x x x x x x
x x x xxxxx  x x x x x x
x x x        x x x x x x
x x xxxxxxxxxx x x x x x
x x            x x   x x
x xxxxxxxxxxxx x xxxxx x
x                      x
x xxxxxxxxxxxxxxxxxxxx x
x x            x       x
x x xxxxxxxxxx x xxxxx x
x x          x x     x x
x xxxxxxxxxx x x xxxxx x
x x        x x x       x
x x xxxxxx x x x xxxxx x
x x x    x x x x       x
x x x xx x x x xxxxxxx xx
x x x x  x  x           x
xxxxxxxxxxxxxxxxxxxxxxx x